111111111111111111111111111111111
1C0000000E01CC0000000000C000000P1
1C0000000001CCC0000000000C0000001
1C00000000000000000000000C0000111
1C00000000000000000000000C00000C1
111111111111111111111111111111111