111111111111111111111111111111111
1C0000000E01C00000000000C000000P1
1C0000000001C011000C0001111100001
1100111110000001000000010C0000111
1000000000000001000000010C00000C1
10000C010000001111100000000000111
100C000110000000000000000000000C1
100000001111110010011100CC0000111
1000000000001C0000000000111000C11
1101101110001001111000000C0000111
1011000010000001C01000000001000C1
10C100001000000100000000000100111
100000011100001111100000111100001
1000000000000001C01000C0001000111
111100000000111100000000011000001
1C0000111000000100111000010111111
1C00000010000000000C0000000000CC1
111111111111111111111111111111111