111111111111111111111111111111111
1C0000000E01CC0000000000C000000P1
1C0000000001CCC0000000000C0000001
1C00000000000000000000000C0000111
1C00000000000001000000000C00000C1
100000010000001111100000000000111
1000000110000000000000000000000C1
1000000011110100100111000C0000111
100000000000000000000000111000C11
1100000000000001111000000C0000111
1000000000000001C01000000000000C1
100000000000000100000000000000111
100000011100001111100000000000001
100000000000000100000000000000111
111100000000111100000000010000001
1C0000000000000100111000010111111
1C00000000000000000C00000000000C1
111111111111111111111111111111111