11111111111111111111111111111111111111111111111111111111111111111111111111111111111111111111111
1C00E00000001C00000000000C000000C00000000001C00000000000C000000C00000000001C00000000000C0000001
1C0000000001C011000C000111110000C00000000001C00000000000C000000C00000000001C00000000000C000P001
1100111110000001000000010C000011C00000000001C00000000000C000000C00000000001C00000000000C0000001
1000000000000001000000010C00000CC00000000000C00000000000C000000C00000000001C00000000000C0000001
10000C01000000111110000000000011C00000000001C00000000000C000000C00000000001C00000000000C0000001
100C000110000000000000000000000CC00000000001C00000000000C000000C00000000001C00000000000C0000001
100000001111110010011100CC000011C00000000001C00000000000C000000C00000000001C00000000000C0000001
1000000000001C0000000000111000C1C00000000001C000000000000000000C00000000001C00000000000C0000001
1101101110001001111000000C000011C00000000001C00000000000C000000C00000000001C00000000000C0000001
1011000010000001C01000000001000CC00000000001C00000000000C000000C00000000001C00000000000C0000001
10C10000100000010000000000010011C00000000001C00000000000C000000C00000000000C0000000000000000001
10000001110000111110000011110000C00000000001C00000000000C000000C00000000001C00000000000C0000001
1000000000000001C01000C000100011C00000000001C00000000000C000000C00000000001C00000000000C0000001
11110000000011110000000001100000000000000001C00000000000C000000C00000000001C00000000000C0000001
1C000011100000010011100001011111C000000000000000000000000000000000000000000C00000000000C0000001
1C00000010000000000C0000000000CCC00000000001C00000000000C000000C00000000001C0000000000000000001
11111111111111111111111111111111111111111111111111111111111111111111111111111111111111111111111