111111111111111111111111111111111111111
1P00010010C010C01001001111C0100000000C1
111011101C10100010010011C11010000111111
1C001C101110100010010011010011100111111
10001000111000101111001101011E110111111
100000011111111011110011000110110111111
111111011111111011110011100110110111111
111111000000000000000000000000000111111
100000011111111011111011000110110111111
1111110111111110110000111C0110110111111
11111100000000000011C000110000000111111
100CC001111111101C110011000110110111111
111111011111111011110011111110111111111
11C00000000000000000000000000000000C111
111111111111111111111111111111111111111